111111111111
10010E100001
1P00C0C01C01
111111111111