1111111111111111111111111111111111
1E0000000000000C00000C000000000001
1010010100100000001001000000010101
1010010010101011011001000000011101
1P0000000C00C01000000000C0000000C1
1111111111111111111111111111111111