1111111111111111111111111111111111
1E00000000000000000000000C00000001
1110010100100000001001000000010101
101001001010101101100111000C010101
1P00000000000010000000000100000001
1110010010101011011001000100010101
1010010010101011010001000000010101
1010010010101011011001000000010101
1010010100100000010001000000010101
1011110011101011000111000000000101
1000010100100000000000000000000101
1C100100000000110110000000C0000101
10100000100010110110C10000000101C1
1111111111111111111111111111111111